updatecommands	updatecommands	prefix	3
shutdown	shutdown	prefix	3
sendmessage	sendmessage	prefix	3
changestatus	changestatus	prefix	3
updatesettings	updatesettings	prefix	3
updatesetting	updatesetting	prefix	2
addsetting	addsetting	prefix	2
removesetting	removesetting	prefix	3
admin	admin	prefix	3
unadmin	unadmin	prefix	3
purge	purge	prefix	3
restrict	restrictuser	prefix	2
unrestrict	unrestrictuser	prefix	2
addresponse	addresponse	prefix	2
removeresponse	removeresponse	prefix	2
oops	oops	prefix	1
commands	commands	prefix	1
help	help	prefix	1
userinfo	userinfo	prefix	1
roll	roll	prefix	1
\o\	customresponse	match	1
/o/	customresponse	match	1
